11111111111111
1CC10000000C01
1CCC0111110001
1CPC1111000001
1CCC11E000C001
11111111111111
