11111111111111
10010000000C01
100C0111110001
10001111000001
1P0011E000C001
11111111111111
