11111111111111
10010000000C01
100C0111110001
10PC1111000001
100011E000C001
11111111111111
